1 1 1 1 1 1  1 1 1 1  1 1 1 1 1 1 1 1 1 1 1 1 1 1 1 1 1 1
3 0 0 0 0 0  0 0 0 0  0 0 0 0 0 0 0 0 0 0 0 0 0 0 0 0 0 4
3 0 0 0 0 0  0 0 0 0  0 0 0 0 0 0 0 0 0 0 0 0 0 0 0 0 0 4
3 0 0 0 0 0  0 0 0 0  0 0 0 0 0 0 0 0 0 0 0 0 0 0 0 0 0 4
3 0 0 0 0 0  0 0 0 0  0 0 0 0 0 0 0 0 0 0 0 0 0 0 0 0 0 4
3 0 0 0 0 0  0 0 0 0  0 0 0 0 0 0 0 0 0 0 0 0 0 0 0 0 0 4
3 0 0 0 0 0 24 2 2 2 23 0 0 0 0 0 0 0 0 0 0 0 0 0 0 0 0 4
3 0 0 0 0 0  4 0 0 0  3 0 0 0 0 0 0 0 0 0 0 0 0 0 0 0 0 4
3 0 0 0 0 0  4 0 0 0  3 0 0 0 0 0 0 0 0 0 0 0 0 0 0 0 0 4
3 0 0 0 0 0  4 0 0 0  3 0 0 0 0 0 0 0 0 0 0 0 0 0 0 0 0 4
3 0 0 0 0 0  4 0 0 0  3 0 0 0 0 0 0 0 0 0 0 0 0 0 0 0 0 4
3 0 0 0 0 0  4 0 0 0  3 0 0 0 0 0 0 0 0 0 0 0 0 0 0 0 0 4
3 0 0 0 0 0  4 0 0 0  3 0 0 0 0 0 0 0 0 0 0 0 0 0 0 0 0 4
3 0 0 0 0 0  4 0 0 0  3 0 0 0 0 0 0 0 0 0 0 0 0 0 0 0 0 4
3 0 0 0 0 0 14 1 1 1 13 0 0 0 0 0 0 0 0 0 0 0 0 0 0 0 0 4
3 0 0 0 0 0  0 0 0 0  0 0 0 0 0 0 0 0 0 0 0 0 0 0 0 0 0 4
3 0 0 0 0 0  0 0 0 0  0 0 0 0 0 0 0 0 0 0 0 0 0 0 0 0 0 4
3 0 0 0 0 0  0 0 0 0  0 0 0 0 0 0 0 0 0 0 0 0 0 0 0 0 0 4
3 0 0 0 0 0  0 0 0 0  0 0 0 0 0 0 0 0 0 0 0 0 0 0 0 0 0 4
3 0 0 0 0 0  0 0 0 0  0 0 0 0 0 0 0 0 0 0 0 0 0 0 0 0 0 4
3 0 0 0 0 0  0 0 0 0  0 0 0 0 0 0 0 0 0 0 0 0 0 0 0 0 0 4
3 0 0 0 0 0  0 0 0 0  0 0 0 0 0 0 0 0 0 0 0 0 0 0 0 0 0 4
3 0 0 0 0 0  0 0 0 0  0 0 0 0 0 0 0 0 0 0 0 0 0 0 0 0 0 4
3 0 0 0 0 0  0 0 0 0  0 0 0 0 0 0 0 0 0 0 0 0 0 0 0 0 0 4
3 0 0 0 0 0  0 0 0 0  0 0 0 0 0 0 0 0 0 0 0 0 0 0 0 0 0 4
3 0 0 0 0 0  0 0 0 0  0 0 0 0 0 0 0 0 0 0 0 0 0 0 0 0 0 4
3 0 0 0 0 0  0 0 0 0  0 0 0 0 0 0 0 0 0 0 0 0 0 0 0 0 0 4
3 0 0 0 0 0  0 0 0 0  0 0 0 0 0 0 0 0 0 0 0 0 0 0 0 0 0 4
3 0 0 0 0 0  0 0 0 0  0 0 0 0 0 0 0 0 0 0 0 0 0 0 0 0 0 4
3 0 0 0 0 0  0 0 0 0  0 0 0 0 0 0 0 0 0 0 0 0 0 0 0 0 0 4
2 2 2 2 2 2  2 2 2 2  2 2 2 2 2 2 2 2 2 2 2 2 2 2 2 2 2 2
