32
32

4   4   4   4   4   3   9   9   9   9   9   9   9   9   8   8   8   8   8   8   8   8   8   7   4   4   4   4   4   4   4   4
4   0   0   0   0   1   9   0   0   9   0   0   0  -5   0   0   0   0   0   0   8   7   0   7   1   0   0   0   0   0   0   4
4   0   0   0   0   1   9   9  14  13  -6   9   9   9   8   0   0   0   0   0   8   7   7   7   1   0   0   0   0   0   0   4
4   0   0   0   0   1   9   0   0   0   0   0   0   9   8   0   0   0   0   0   8   7   0   7   1   0   0   0   0   0   0   4
4   0   0   0   0   1   9   0   0   0   0   0   0   9   8   0   0   0   0   0   8   7   0   7   1   0   0   0   0   0   0   4
4   0   0   0   0   1  10   0   0   0   0   0   0   9   8   8   8   8   8   8   8   7   0   7   1   0   0   0   0   0   0   4
4   0   0   0   0   1  11   0   0   0   0   0   0   9   9   9   7   7   7   7   7   7   0   7   1   0   0   0   0   0   0   4
4   0   0   0   0   1  10   0   0   0   0   0   0   0   0  -4   0   0   0   0   0   0   0   7   1   0   0   0   0   0   0   4
4   0   0   0   0   1   9   0   0   9   9   9   9   9   9   9   0   0   0   0   0   0   0   7   1   0   0   0   0   0   0   4
4   0   0   0   0   1   9   0   0  15   2   8   2   0   0   7   7   7   0   0   0   0   0   7   1   0   0   0   0   0   0   4
4   0   0   0   0   1   9   0   9   0   3   0   2   2   2   2   2   7   0   0   0   0   0   7   1   0   0   0   0   0   0   4
4   0   0   0   0   1   9   0   9   0   3   0   0   0   0   0   0   2   7   0   7   7   7   7   1   0   0   0   0   0   0   4
4   0   0   0   0   1   9   0   9   0   6   0   0   0   0   0   0   2   7   0   7   1   1   1   1   0   0   0   0   0   0   4
4   0   0   0   0   1   9   0   9   0   7   0   0   0   0   2   0   2   1   7   1   0   0   0   0   0   0   0   0   0   0   4
4   0   0   0   0   1   9   0   9   3   3   0   0   0   0   2   0   2   1   1   1   0   0   0   0   0   0   0   0   0   0   4
4   0   0   0   0   1   9   0  -3   0   0   0   0   0   0   2   0   2   1   0   0   0   0   0   0   0   0   0   0   0   0   4
4   0   0   0   0   1   9   9   9   3   3   3   3   3   3   2   0   2   1   0   0   0   0   0   0   0   0   0   0   0   0   4
4   0   0   0   0   1   1   1   1   1   1   1   1   1   1  21  -1  12   1   0   0   0   0   0   0   0   0   0   0   0   0   4
4   0   0   0   0   0   0   0   0   0   0   0   0   0   0   0  -2   0   0   0   0   0   0   0   0   0   0   0   0   0   0   4
4   0   0   0   0   0   0   0   0   0   0   0   0   0   0   0   0   0   0   0   0   0   0   0   0   0   0   0   0   0   0   4
4   0   0   0   0   0   0   0   0   0   0   0   0   0   0   0   0   0   0   0   0   0   0   0   0   0   0   0   0   0   0   4
4   0   0   0   0   0   0   0   0   0   0   0   0   0   0   0   0   0   0   0   0   0   0   0   0   0   0   0   0   0   0   4
4   0   0   0   0   0   0   0   0   0   0   0   0   0   0   0   0   0   0   0   0   0   0   0   0   0   0   0   0   0   0   4
4   0   0   0   0   0   0   0   0   0   0   0   0   0   0   0   0   0   0   0   0   0   0   0   0   0   0   0   0   0   0   4
4   0   0   0   0   0   0   0   0   0   0   0   0   0   0   0   0   0   0   0   0   0   0   0   0   0   0   0   0   0   0   4
4   0   0   0   0   0   0   0   0   0   0   0   0   0   0   0   0   0   0   0   0   0   0   0   0   0   0   0   0   0   0   4
4   0   0   0   0   0   0   0   0   0   0   0   0   0   0   0   0   0   0   0   0   0   0   0   0   0   0   0   0   0   0   4
4   0   0   0   0   0   0   0   0   0   0   0   0   0   0   0   0   0   0   0   0   0   0   0   0   0   0   0   0   0   0   4
4   0   0   0   0   0   0   0   0   0   0   0   0   0   0   0   0   0   0   0   0   0   0   0   0   0   0   0   0   0   0   4
4   0   0   0   0   0   0   0   0   0   0   0   0   0   0   0   0   0   0   0   0   0   0   0   0   0   0   0   0   0   0   4
4   0   0   0   0   0   0   0   0   0   0   0   0   0   0   0   0   0   0   0   0   0   0   0   0   0   0   0   0   0   0   4
4   4   4   4   4   4   4   4   4   4   4   4   4   4   4   4   4   4   4   4   4   4   4   4   4   4   4   4   4   4   4   4

-4  -4  -4  -4  -4  -1  -1  -3  -3  -3  -3  -3  -3  -3  -8  -8  -8  -8  -8  -8  -8  -8  -8  -7  -4  -4  -4  -4  -4  -4  -4  -4
-4   0   0   0   0  -1  -1   3   3   3   3   3   3   3   3   0   0   0   0   0   0   0   0  -7  -1   0   0   0   0   0   0  -4
-4   0   0   0   0  -1  -1   3   3   3   3   3   3  -3  -8   0   0   0   0   0  -8  -7   0  -7  -1   0   0   0   0   0   0  -4
-4   0   0   0   0  -1  -3   3   3   3   3   3   3  -3  -8   0   0   0   0   0  -8  -7   0  -7  -1   0   0   0   0   0   0  -4
-4   0   0   0   0  -1  -3   3   3   3   3   3   3  -3  -8   0   0   0   0   0  -8  -7   0  -7  -1   0   0   0   0   0   0  -4
-4   0   0   0   0  -1  -3   3   3   3   3   3   3  -3  -8  -8  -8  -8  -8  -8  -8  -7   0  -7  -1   0   0   0   0   0   0  -4
-4   0   0   0   0  -1  -3   3   3   3   3   3   3  -3  -3  -7  -7  -7  -7  -7  -7  -7   0  -7  -1   0   0   0   0   0   0  -4
-4   0   0   0   0  -1  -3   3   3   3   3   3   3   3   3   0   0   0   0   0   0   0   0  -7  -1   0   0   0   0   0   0  -4
-4   0   0   0   0  -1  -3   3   3  -3  -3  -3  -3  -3  -3  -7   0   0   0   0   0   0   0  -7  -1   0   0   0   0   0   0  -4
-4   0   0   0   0  -1  -3   3   3  -3  -2  -2  -2   0   0  -7  -7  -7   0   0   0   0   0  -7  -1   0   0   0   0   0   0  -4
-4   0   0   0   0  -1  -3   3  -3   0  -2   1  -2  -2  -2  -2  -2  -7   0   0   0   0   0  -7  -1   0   0   0   0   0   0  -4
-4   0   0   0   0  -1  -3   3  -3   0  -2   1   1   1   1   1   1  -2  -7   0  -7  -7  -7  -7  -1   0   0   0   0   0   0  -4
-4   0   0   0   0  -1  -3   3  -3   0  -2   1   1   1   1   1   1  -2  -7   0  -7  -1  -1  -1  -1   0   0   0   0   0   0  -4
-4   0   0   0   0  -1  -3   3  -3   0  -2   1   1   1   1  -2   1  -2  -1  -7  -1   0   0   0   0   0   0   0   0   0   0  -4
-4   0   0   0   0  -1  -3   3  -2  -2  -2   1   1   1   1  -2   1  -2  -1  -1  -1   0   0   0   0   0   0   0   0   0   0  -4
-4   0   0   0   0  -1  -3   3   1   1   1   1   1   1   1  -2   1  -2  -1   0   0   0   0   0   0   0   0   0   0   0   0  -4
-4   0   0   0   0  -1  -3  -3  -2  -2  -2  -2  -2  -2  -2  -2   1  -2  -1   0   0   0   0   0   0   0   0   0   0   0   0  -4
-4   0   0   0   0  -1  -1  -1  -1  -1  -1  -1  -1  -1  -1  -1   1  -1  -1   0   0   0   0   0   0   0   0   0   0   0   0  -4
-4   0   0   0   0   0   0   0   0   0   0   0   0   0   0   0   0   0   0   0   0   0   0   0   0   0   0   0   0   0   0  -4
-4   0   0   0   0   0   0   0   0   0   0   0   0   0   0   0   0   0   0   0   0   0   0   0   0   0   0   0   0   0   0  -4
-4   0   0   0   0   0   0   0   0   0   0   0   0   0   0   0   0   0   0   0   0   0   0   0   0   0   0   0   0   0   0  -4
-4   0   0   0   0   0   0   0   0   0   0   0   0   0   0   0   0   0   0   0   0   0   0   0   0   0   0   0   0   0   0  -4
-4   0   0   0   0   0   0   0   0   0   0   0   0   0   0   0   0   0   0   0   0   0   0   0   0   0   0   0   0   0   0  -4
-4   0   0   0   0   0   0   0   0   0   0   0   0   0   0   0   0   0   0   0   0   0   0   0   0   0   0   0   0   0   0  -4
-4   0   0   0   0   0   0   0   0   0   0   0   0   0   0   0   0   0   0   0   0   0   0   0   0   0   0   0   0   0   0  -4
-4   0   0   0   0   0   0   0   0   0   0   0   0   0   0   0   0   0   0   0   0   0   0   0   0   0   0   0   0   0   0  -4
-4   0   0   0   0   0   0   0   0   0   0   0   0   0   0   0   0   0   0   0   0   0   0   0   0   0   0   0   0   0   0  -4
-4   0   0   0   0   0   0   0   0   0   0   0   0   0   0   0   0   0   0   0   0   0   0   0   0   0   0   0   0   0   0  -4
-4   0   0   0   0   0   0   0   0   0   0   0   0   0   0   0   0   0   0   0   0   0   0   0   0   0   0   0   0   0   0  -4
-4   0   0   0   0   0   0   0   0   0   0   0   0   0   0   0   0   0   0   0   0   0   0   0   0   0   0   0   0   0   0  -4
-4   0   0   0   0   0   0   0   0   0   0   0   0   0   0   0   0   0   0   0   0   0   0   0   0   0   0   0   0   0   0  -4
-4  -4  -4  -4  -4  -4  -4  -4  -4  -4  -4  -4  -4  -4  -4  -4  -4  -4  -4  -4  -4  -4  -4  -4  -4  -4  -4  -4  -4  -4  -4  -4

0   0   0   0   0   0   0   0   0   0   0   0   0   0   0   0   0   0   0   0   0   0   0   0   0   0   0   0   0   0   0   0
0   0   0   0   0   0   0   0   0   0   0   0   5   0   0   0   0   0   0   0   0   0   0   0   0   0   0   0   0   0   0   0
0   0   0   0   0   0   0   0   0   0   0   0   0   0   0   0   0   0   0   0   0   0   0   0   0   0   0   0   0   0   0   0
0   0   0   0   0   0   0   0   0   0   0   0   0   0   0   0   0   0   0   0   0   0   0   0   0   0   0   0   0   0   0   0
0   0   0   0   0   0   0   0   0   0   0   0   0   0   0   0   0   0   0   0   0   0   0   0   0   0   0   0   0   0   0   0
0   0   0   0   0   0   0   0   0   9   0   9   0   0   0   0   0   0   0   0   0   0   0   0   0   0   0   0   0   0   0   0
0   0   0   0   0   0   0   0   0   0   0   0   0   0   0   0   0   0   0   0   0   0   0   0   0   0   0   0   0   0   0   0
0   0   0   0   0   0   0   0   0   0   0   0   0   0   4   0   0   0   0   0   0   0   0   0   0   0   0   0   0   0   0   0
0   0   0   0   0   0   0   0   0   0   0   0   0   0   0   0   0   0   0   0   0   0   0   0   0   0   0   0   0   0   0   0
0   0   0   0   0   0   0   0   0   0   0   0   0   0   0   0   0   0   0   0   0   0   0   0   0   0   0   0   0   0   0   0
0   0   0   0   0   0   0   0   0   0   0   0   0   0   0   0   0   0   0   0   0   0   0   0   0   0   0   0   0   0   0   0
0   0   0   0   0   0   0   0   0   0   0   0   0   0   0   0   0   0   0   0   0   0   0   0   0   0   0   0   0   0   0   0
0   0   0   0   0   0   0   0   0   0   0   0   7   0   0   0   0   0   0   0   0   0   0   0   0   0   0   0   0   0   0   0
0   0   0   0   0   0   0   0   0   0   0   0   7  -6   0   0   0   0   0   0   0   0   0   0   0   0   0   0   0   0   0   0
0   0   0   0   0   0   0   0   0   0   0   0   0   0   0   0   0   0   0   0   0   0   0   0   0   0   0   0   0   0   0   0
0   0   0   0   0   0   0   0   0  -3   0   0   0   0   8   0   0   0   0   0   0   0   0   0   0   0   0   0   0   0   0   0
0   0   0   0   0   0   0   0   0   0   0   0   0   0   0   0   0   0   0   0   0   0   0   0   0   0   0   0   0   0   0   0
0   0   0   0   0   0   0   0   0   0   0   0   0   0   0   0   0   0   0   0   0   0   0   0   0   0   0   0   0   0   0   0
0   0   0   0   0   0   0   0   0   0   0   0   0   0   0   0   0   0   0   0   0   0   0   0   0   0   0   0   0   0   0   0
0   0   0   0   0   0   0   0   0   0   0   0   0   0   0   0   0   0   0   0   0   0   0   0   0   0   0   0   0   0   0   0
0   0   0   0   0   0   0   0   0   0   0   0   0   0   0   0   0   0   0   0   0   0   0   0   0   0   0   0   0   0   0   0
0   0   0   0   0   0   0   0   0   0   0   0   0   0   0   0   0   0   0   0   0   0   0   0   0   0   0   0   0   0   0   0
0   0   0   0   0   0   0   0   0   0   0   0   0   0   0   0   0   0   0   0   0   0   0   0   0   0   0   0   0   0   0   0
0   0   0   0   0   0   0   0   0   0   0   0   0   0   0   0   0   0   0   0   0   0   0   0   0   0   0   0   0   0   0   0
0   0   0   0   0   0   0   0   0   0   0   0   0   0   0   0   0   0   0   0   0   0   0   0   0   0   0   0   0   0   0   0
0   0   0   0   0   0   0   0   0   0   0   0   0   0   0   0   0   0   0   0   0   0   0   0   0   0   0   0   0   0   0   0
0   0   0   0   0   0   0   0   0   0   0   0   0   0   0   0   0   0   0   0   0   0   0   0   0   0   0   0   0   0   0   0
0   0   0   0   0   0   0   0   0   0   0   0   0   0   0   0   0   0   0   0   0   0   0   0   0   0   0   0   0   0   0   0
0   0   0   0   0   0   0   0   0   0   0   0   0   0   0   0   0   0   0   0   0   0   0   0   0   0   0   0   0   0   0   0
0   0   0   0   0   0   0   0   0   0   0   0   0   0   0   0   0   0   0   0   0   0   0   0   0   0   0   0   0   0   0   0
0   0   0   0   0   0   0   0   0   0   0   0   0   0   0   0   0   0   0   0   0   0   0   0   0   0   0   0   0   0   0   0
0   0   0   0   0   0   0   0   0   0   0   0   0   0   0   0   0   0   0   0   0   0   0   0   0   0   0   0   0   0   0   0
