32
32

4   4   4   4   4   3   9   9   9   9   9   9   9  20  20  20  22  23  24  20  20   8   8   7   4   4   4   4   4   4   4   4
4   0   0   0   0   1   9   0   0   9   0   0   0  -5   0   0   0   0   0   0  22   7   0   7   1   0   0   0   0   0   0   4
4   0   0   0   0   1   9   9  14  13  -6   9   9  20  20   0   0  -7   0   0  23   7   0   7   1   0   0   0   0   0   0   4
4   0   0   0   0   1   9   0   0   0   0   0   0   9  20   0   0   0   0   0  24   7   0   7   1   0   0   0   0   0   0   4
4   0   0   0   0   1   9   0   0   0   0   0   0   9  20   0   0   0   0   0  20  16  19  16   1   0   0   0   0   0   0   4
4   0   0   0   0   1  10   0   0   0   0   0   0   9  20  20  24  23  22  20  20  16   0  16   1   0   0   0   0   0   0   4
4   0   0   0   0   1  11   0   0   0   0   0   0   9   9  16  16  16  16  16  16  16   0  16   1   0   0   0   0   0   0   4
4   0   0   0   0   1  10   0   0   0   0   0   0   0   0  -4   0   0   0   0   0   0   0  16   1   0   0   0   0   0   0   4
4   0   0   0   0   1   9   0   0   9   9   9   9   9   9  16   0   0   0   0   0   0   0  17   1   0   0   0   0   0   0   4
4   0   0   0   0   1   9   0   0  15   2   8   2   0   0  16  16  16   0   0   0   0   0  16   1   0   0   0   0   0   0   4
4   0   0   0   0   1   9   0   9   0   3   0   2   2   2   2   2  16   0   0   0   0   0  16   1   0   0   0   0   0   0   4
4   0   0   0   0   1   9   0   9   0   3   0   0   0   0   0   0   2  16   0   0   0   0  16   1   0   0   0   0   0   0   4
4   0   0   0   0   1   9   0   9   0   6   0   0   0   0   0   0   2  16   0  16  16  16  16   1   0   0   0   0   0   0   4
4   0   0   0   0   1   9   0   9   0   7   0   0   0   0   2   0   2   1  18   1   1   1   1   1   0   0   0   0   0   0   4
4   0   0   0   0   1   9   0   9   3   3   0   0   0   0   2   0   2   1   1   1   0   0   0   0   0   0   0   0   0   0   4
4   0   0   0   0   1   9   0  -3   0   0   0   0   0   0   2   0   2   1   0   0   0   0   0   0   0   0   0   0   0   0   4
4   0   0   0   0   1   9   9   9   3   3   3   3   3   3   2   0   2   1   0   0   0   0   0   0   0   0   0   0   0   0   4
4   0   0   0   0   1   1   1   1   1   1   1   1   1   1  21  -1  12   1   0   0   0   0   0   0   0   0   0   0   0   0   4
4   0   0   0   0   0   0   0   0   0   0   0   0   0   0   0  -2   0   0   0   0   0   0   0   0   0   0   0   0   0   0   4
4   0   0   0   0   0   0   0   0   0   0   0   0   0   0   0   0   0   0   0   0   0   0   0   0   0   0   0   0   0   0   4
4   0   0   0   0   0   0   0   0   0   0   0   0   0   0   0   0   0   0   0   0   0   0   0   0   0   0   0   0   0   0   4
4   0   0   0   0   0   0   0   0   0   0   0   0   0   0   0   0   0   0   0   0   0   0   0   0   0   0   0   0   0   0   4
4   0   0   0   0   0   0   0   0   0   0   0   0   0   0   0   0   0   0   0   0   0   0   0   0   0   0   0   0   0   0   4
4   0   0   0   0   0   0   0   0   0   0   0   0   0   0   0   0   0   0   0   0   0   0   0   0   0   0   0   0   0   0   4
4   0   0   0   0   0   0   0   0   0   0   0   0   0   0   0   0   0   0   0   0   0   0   0   0   0   0   0   0   0   0   4
4   0   0   0   0   0   0   0   0   0   0   0   0   0   0   0   0   0   0   0   0   0   0   0   0   0   0   0   0   0   0   4
4   0   0   0   0   0   0   0   0   0   0   0   0   0   0   0   0   0   0   0   0   0   0   0   0   0   0   0   0   0   0   4
4   0   0   0   0   0   0   0   0   0   0   0   0   0   0   0   0   0   0   0   0   0   0   0   0   0   0   0   0   0   0   4
4   0   0   0   0   0   0   0   0   0   0   0   0   0   0   0   0   0   0   0   0   0   0   0   0   0   0   0   0   0   0   4
4   0   0   0   0   0   0   0   0   0   0   0   0   0   0   0   0   0   0   0   0   0   0   0   0   0   0   0   0   0   0   4
4   0   0   0   0   0   0   0   0   0   0   0   0   0   0   0   0   0   0   0   0   0   0   0   0   0   0   0   0   0   0   4
4   4   4   4   4   4   4   4   4   4   4   4   4   4   4   4   4   4   4   4   4   4   4   4   4   4   4   4   4   4   4   4

-4  -4  -4  -4  -4  -1  -1  -3  -3  -3  -3  -3  -3  -3  -8  -8  -8  -8  -8  -8  -8  -8  -8  -7  -4  -4  -4  -4  -4  -4  -4  -4
-4   0   0   0   0  -1  -1   3   3   3   3   3   3   7   7   7   7   7   7   7  -8   0   0  -7  -1   0   0   0   0   0   0  -4
-4   0   0   0   0  -1  -1   3   3   3   3   3   3  -3  -8   7   7   7   7   7  -8  -7   0  -7  -1   0   0   0   0   0   0  -4
-4   0   0   0   0  -1  -3   3   3   3   3   3   3  -3  -8   7   7   7   7   7  -8  -7   0  -7  -1   0   0   0   0   0   0  -4
-4   0   0   0   0  -1  -3   3   3   3   3   3   3  -3  -8   7   7   7   7   7  -8  -7  -7  -7  -1   0   0   0   0   0   0  -4
-4   0   0   0   0  -1  -3   3   3   3   3   3   3  -3  -8  -8  -8  -8  -8  -8  -8  -7   5  -7  -1   0   0   0   0   0   0  -4
-4   0   0   0   0  -1  -3   3   3   3   3   3   3  -3  -3  -7  -7  -7  -7  -7  -7  -7   5  -7  -1   0   0   0   0   0   0  -4
-4   0   0   0   0  -1  -3   3   3   3   3   3   3   3   3   5   5   5   5   5   5   5   5  -7  -1   0   0   0   0   0   0  -4
-4   0   0   0   0  -1  -3   3   3  -3  -3  -3  -3  -3  -3  -7   5   5   5   9  13  17   5  -7  -1   0   0   0   0   0   0  -4
-4   0   0   0   0  -1  -3   3   3  -3  -2  -2  -2   0   0  -7  -7  -7   5  10  14  18   5  -7  -1   0   0   0   0   0   0  -4
-4   0   0   0   0  -1  -3   3  -3   0  -2   1  -2  -2  -2  -2  -2  -7   5  11  15  19   5  -7  -1   0   0   0   0   0   0  -4
-4   0   0   0   0  -1  -3   3  -3   0  -2   1   1   1   1   1   1  -2  -7  12  16  20   5  -7  -1   0   0   0   0   0   0  -4
-4   0   0   0   0  -1  -3   3  -3   0  -2   1   1   1   1   1   1  -2  -7   5  -7  -1  -1  -7  -1   0   0   0   0   0   0  -4
-4   0   0   0   0  -1  -3   3  -3   0  -2   1   1   1   1  -2   1  -2  -1  -7  -1  -1  -1  -1  -1   0   0   0   0   0   0  -4
-4   0   0   0   0  -1  -3   3  -2  -2  -2   1   1   1   1  -2   1  -2  -1  -1  -1   0   0   0   0   0   0   0   0   0   0  -4
-4   0   0   0   0  -1  -3   3   1   1   1   1   1   1   1  -2   1  -2  -1   0   0   0   0   0   0   0   0   0   0   0   0  -4
-4   0   0   0   0  -1  -3  -3  -2  -2  -2  -2  -2  -2  -2  -2   1  -2  -1   0   0   0   0   0   0   0   0   0   0   0   0  -4
-4   0   0   0   0  -1  -1  -1  -1  -1  -1  -1  -1  -1  -1  -1   1  -1  -1   0   0   0   0   0   0   0   0   0   0   0   0  -4
-4   0   0   0   0   0   0   0   0   0   0   0   0   0   0   0   0   0   0   0   0   0   0   0   0   0   0   0   0   0   0  -4
-4   0   0   0   0   0   0   0   0   0   0   0   0   0   0   0   0   0   0   0   0   0   0   0   0   0   0   0   0   0   0  -4
-4   0   0   0   0   0   0   0   0   0   0   0   0   0   0   0   0   0   0   0   0   0   0   0   0   0   0   0   0   0   0  -4
-4   0   0   0   0   0   0   0   0   0   0   0   0   0   0   0   0   0   0   0   0   0   0   0   0   0   0   0   0   0   0  -4
-4   0   0   0   0   0   0   0   0   0   0   0   0   0   0   0   0   0   0   0   0   0   0   0   0   0   0   0   0   0   0  -4
-4   0   0   0   0   0   0   0   0   0   0   0   0   0   0   0   0   0   0   0   0   0   0   0   0   0   0   0   0   0   0  -4
-4   0   0   0   0   0   0   0   0   0   0   0   0   0   0   0   0   0   0   0   0   0   0   0   0   0   0   0   0   0   0  -4
-4   0   0   0   0   0   0   0   0   0   0   0   0   0   0   0   0   0   0   0   0   0   0   0   0   0   0   0   0   0   0  -4
-4   0   0   0   0   0   0   0   0   0   0   0   0   0   0   0   0   0   0   0   0   0   0   0   0   0   0   0   0   0   0  -4
-4   0   0   0   0   0   0   0   0   0   0   0   0   0   0   0   0   0   0   0   0   0   0   0   0   0   0   0   0   0   0  -4
-4   0   0   0   0   0   0   0   0   0   0   0   0   0   0   0   0   0   0   0   0   0   0   0   0   0   0   0   0   0   0  -4
-4   0   0   0   0   0   0   0   0   0   0   0   0   0   0   0   0   0   0   0   0   0   0   0   0   0   0   0   0   0   0  -4
-4   0   0   0   0   0   0   0   0   0   0   0   0   0   0   0   0   0   0   0   0   0   0   0   0   0   0   0   0   0   0  -4
-4  -4  -4  -4  -4  -4  -4  -4  -4  -4  -4  -4  -4  -4  -4  -4  -4  -4  -4  -4  -4  -4  -4  -4  -4  -4  -4  -4  -4  -4  -4  -4

0   0   0   0   0   0   0   0   0   0   0   0   0   0   0   0   0   0   0   0   0   0   0   0   0   0   0   0   0   0   0   0
0   0   0   0   0   0   0   0   0   0   0   0   5   0   0   0   0   0   0   0   0   0   0   0   0   0   0   0   0   0   0   0
0   0   0   0   0   0   0   0   0   0   0   0   0   0   0   0   0   1   0   0   0   0   0   0   0   0   0   0   0   0   0   0
0   0   0   0   0   0   0   0   0   0   0   0   0   0   0   0   0   0   0   0   0   0   0   0   0   0   0   0   0   0   0   0
0   0   0   0   0   0   0   0   0   0   0   0   0   0   0   0   0   0   0   0   0   0   0   0   0   0   0   0   0   0   0   0
0   0   0   0   0   0   0   0   0   9   0   9   0   0   0   0   0   0   0   0   0   0   0   0   0   0   0   0   0   0   0   0
0   0   0   0   0   0   0   0   0   0   0   0   0   0   0   0   0   0   0   0   0   0   0   0   0   0   0   0   0   0   0   0
0   0   0   0   0   0   0   0   0   0   0   0   0   0   4   0   0   0   0   0   0   0   0   0   0   0   0   0   0   0   0   0
0   0   0   0   0   0   0   0   0   0   0   0   0   0   0   0   0   0   0   0   0   0   0   0   0   0   0   0   0   0   0   0
0   0   0   0   0   0   0   0   0   0   0   0   0   0   0   0   0   0  11   0   0   0   0   0   0   0   0   0   0   0   0   0
0   0   0   0   0   0   0   0   0   0   0   0   0   0   0   0   0   0  10   0   0  11   0   0   0   0   0   0   0   0   0   0
0   0   0   0   0   0   0   0   0   0   0   0   0   0   0   0   0   0   0   0   0   0  12   0   0   0   0   0   0   0   0   0
0   0   0   0   0   0   0   0   0   0   0   0   7   0   0   0   0   0   0   0   0   0   0   0   0   0   0   0   0   0   0   0
0   0   0   0   0   0   0   0   0   0   0   0   7  -6   0   0   0   0   0   0   0   0   0   0   0   0   0   0   0   0   0   0
0   0   0   0   0   0   0   0   0   0   0   0   0   0   0   0   0   0   0   0   0   0   0   0   0   0   0   0   0   0   0   0
0   0   0   0   0   0   0   0   0  -3   0   0   0   0   8   0   0   0   0   0   0   0   0   0   0   0   0   0   0   0   0   0
0   0   0   0   0   0   0   0   0   0   0   0   0   0   0   0   0   0   0   0   0   0   0   0   0   0   0   0   0   0   0   0
0   0   0   0   0   0   0   0   0   0   0   0   0   0   0   0   0   0   0   0   0   0   0   0   0   0   0   0   0   0   0   0
0   0   0   0   0   0   0   0   0   0   0   0   0   0   0   0   0   0   0   0   0   0   0   0   0   0   0   0   0   0   0   0
0   0   0   0   0   0   0   0   0   0   0   0   0   0   0   0   0   0   0   0   0   0   0   0   0   0   0   0   0   0   0   0
0   0   0   0   0   0   0   0   0   0   0   0   0   0   0   0   0   0   0   0   0   0   0   0   0   0   0   0   0   0   0   0
0   0   0   0   0   0   0   0   0   0   0   0   0   0   0   0   0   0   0   0   0   0   0   0   0   0   0   0   0   0   0   0
0   0   0   0   0   0   0   0   0   0   0   0   0   0   0   0   0   0   0   0   0   0   0   0   0   0   0   0   0   0   0   0
0   0   0   0   0   0   0   0   0   0   0   0   0   0   0   0   0   0   0   0   0   0   0   0   0   0   0   0   0   0   0   0
0   0   0   0   0   0   0   0   0   0   0   0   0   0   0   0   0   0   0   0   0   0   0   0   0   0   0   0   0   0   0   0
0   0   0   0   0   0   0   0   0   0   0   0   0   0   0   0   0   0   0   0   0   0   0   0   0   0   0   0   0   0   0   0
0   0   0   0   0   0   0   0   0   0   0   0   0   0   0   0   0   0   0   0   0   0   0   0   0   0   0   0   0   0   0   0
0   0   0   0   0   0   0   0   0   0   0   0   0   0   0   0   0   0   0   0   0   0   0   0   0   0   0   0   0   0   0   0
0   0   0   0   0   0   0   0   0   0   0   0   0   0   0   0   0   0   0   0   0   0   0   0   0   0   0   0   0   0   0   0
0   0   0   0   0   0   0   0   0   0   0   0   0   0   0   0   0   0   0   0   0   0   0   0   0   0   0   0   0   0   0   0
0   0   0   0   0   0   0   0   0   0   0   0   0   0   0   0   0   0   0   0   0   0   0   0   0   0   0   0   0   0   0   0
0   0   0   0   0   0   0   0   0   0   0   0   0   0   0   0   0   0   0   0   0   0   0   0   0   0   0   0   0   0   0   0
